15
20
+++I++++++++++++++++
+++ ++++++++++++   +
+++      +++++++ + +
+   ++++ ++   ++ + +
+ ++++++ ++ + ++ + +
+ ++++++ ++ + ++ + +
+   ++++    +    + +
+++ ++++++++++++++ +
+++ ++++++++++++++ +
+   ++++           +
+ ++++++++++ +++++++
+  ++     ++ +++++++
++ ++ +++ ++     +++
++    +++ ++ +++ +++
++++++++++++++++O+++